recommend: ['recommends', 'recommendation', 'recommended', 'recommend', 'recommending', 'recommendations']
greco: ['greco', 'GRECO']
report: ['reported', 'report', 'Report', 'reports', 'reporting', 'Reported', 'reporters', 'Reporting', 'Reports', 'reporter', 'Reporters', 'Reporter']
public: ['publicized', 'Public', 'publications', 'publicize', 'publicity', 'publication', 'publics', 'public']
law: ['Laws', 'laws', 'lawful', 'Law', 'lawfulness', 'law']
author: ['authorities', 'authorize', 'authorization', 'Authorities', 'authors', 'authority', 'authorizes', 'authored', 'Authority', 'author', 'authorizing', 'authorized']
inform: ['informer', 'informing', 'informants', 'inform', 'Informal', 'informal', 'informers', 'informed', 'informs', 'informally', 'Information', 'informant', 'information']
implement: ['implements', 'implementable', 'implementation', 'implementer', 'implemented', 'implementing', 'implement']
member: ['Member', 'members', 'member', 'Members']
offic: ['offices', 'offic', 'office', 'officers', 'Office', 'officer']
provid: ['provides', 'Providence', 'Providers', 'provide', 'provider', 'providing', 'provided', 'providers']
state: ['States', 'State', 'stating', 'state', 'states', 'stated']
rule: ['ruling', 'Ruling', 'Rule', 'Rules', 'rule', 'Rulings', 'rulings', 'rules', 'ruled']
also: ['also', 'Also']
includ: ['including', 'Including', 'includes', 'include', 'included']
interest: ['interests', 'Interest', 'interest', 'Interested', 'interested', 'interesting']
gener: ['generic', 'Generally', 'generally', 'generating', 'general', 'generations', 'generous', 'generator', 'generation', 'generates', 'generals', 'generate', 'generated', 'General']
feder: ['Federal', 'federated', 'federal', 'federation', 'federations', 'Federation']
minist: ['ministers', 'minister', 'Ministers', 'Minister']
code: ['Code', 'codes', 'code', 'coded', 'Codes']
case: ['cases', 'Case', 'case', 'Cases']
parti: ['Party', 'partie', 'party', 'parties', 'Parties']
activ: ['activating', 'Active', 'activities', 'active', 'Activity', 'activated', 'activism', 'Activities', 'activate', 'activation', 'activity', 'actively']
may: ['may', 'May']
polit: ['politely', 'politically', 'politics', 'Political', 'Politically', 'Politics', 'political']
council: ['council', 'Councils', 'councils', 'Council']
servic: ['services', 'Service', 'Services', 'service']
ethic: ['ethical', 'ethic', 'Ethics', 'ethically', 'ethics']
procedur: ['Procedural', 'procedural', 'procedure', 'procedures', 'procedur', 'Procedure']
parliament: ['Parliament', 'parliaments', 'parliament']
requir: ['requirement', 'requiring', 'required', 'Requirements', 'requirements', 'require', 'requires']
adopt: ['Adoption', 'adoption', 'adopted', 'adopts', 'adoptions', 'adoptive', 'adopting', 'Adopted', 'adopt']
concern: ['concern', 'concerning', 'concerns', 'Concerns', 'concerned', 'Concerning']
judici: ['Judicial', 'judicial']
year: ['Year', 'years', 'year', 'Years']
offici: ['Officials', 'Official', 'officiate', 'officiers', 'officially', 'official', 'officials']
declar: ['declares', 'declarers', 'declare', 'declarant', 'declarants', 'declarable', 'declaring', 'declaration', 'declarations', 'declared', 'declarative']
crimin: ['Criminal', 'criminalization', 'criminalizing', 'criminality', 'criminalizes', 'criminals', 'criminal', 'criminalize', 'criminally', 'criminalized']
respect: ['respect', 'respecting', 'respective', 'respects', 'respectively', 'respected']
conduct: ['conducting', 'conduction', 'conduct', 'conducted', 'conducts', 'Conducting']
act: ['acting', 'acts', 'Act', 'acted', 'actes', 'act', 'Acting', 'Acts']
complianc: ['compliance']
regard: ['regard', 'regarding', 'regarded', 'regards', 'Regarding']
right: ['right', 'Right', 'rights', 'Rights']
person: ['personalized', 'Persons', 'personalities', 'Personal', 'personalization', 'personal', 'person', 'personally', 'persons', 'personality']
administr: ['administrators', 'Administrative', 'administrator', 'administrative', 'administration', 'Administration', 'administratively', 'administrations']
howev: ['However', 'however']
legisl: ['legislator', 'Legislation', 'legislate', 'legislation', 'Legislators', 'legislators', 'Legislative', 'legislative']
new: ['New', 'new', 'News']
constitut: ['constitute', 'Constitutional', 'Constitution', 'constituted', 'constituting', 'constitutional', 'constitution', 'constitutionally', 'Constitute', 'constitutes', 'constitutive']
articl: ['Articles', 'article', 'Article', 'articles']
note: ['noted', 'note', 'notes', 'noting']
prevent: ['preventative', 'Preventing', 'preventing', 'prevention', 'preventively', 'prevents', 'preventive', 'Prevention', 'prevent', 'prevented']
evalu: ['evaluator', 'evaluated', 'evaluations', 'evaluating', 'evaluate', 'evaluators', 'evaluation', 'Evaluation', 'evaluates']
conflict: ['Conflict', 'Conflicts', 'conflict', 'conflicting', 'conflicts']
get: ['gets', 'getting', 'get']
appoint: ['appointing', 'appoint', 'Appointments', 'appointments', 'appointed', 'Appointment', 'appoints', 'appointment']
measur: ['measurable', 'Measures', 'measure', 'measuring', 'measures', 'measurement', 'Measuring']
work: ['Work', 'Working', 'Works', 'work', 'worked', 'working', 'works', 'workings']
remain: ['remain', 'remaining', 'remained', 'remains']
issu: ['issued', 'issues', 'issue', 'Issued', 'issuing']
legal: ['legal', 'Legally', 'legalize', 'legalized', 'legality', 'Legalize', 'legally', 'legalization', 'legalizing', 'Legal']
decis: ['Decision', 'decisions', 'decisive', 'decisively', 'Decisions', 'decision']
part: ['parts', 'Parts', 'part', 'Part', 'partes']
nation: ['national', 'National', 'nationality', 'Nations', 'nationalized', 'nation', 'nationally', 'nationals', 'nationalism', 'nations']
integr: ['integrity', 'integrating', 'Integration', 'Integrity', 'integrated', 'integrate', 'integration', 'integral']
access: ['accessing', 'accessibility', 'Access', 'access', 'accessed', 'accession', 'accessible']
would: ['Would', 'would']
system: ['System', 'systemic', 'systems', 'system', 'Systems']
practic: ['practice', 'practically', 'Practice', 'Practices', 'practicalities', 'practices', 'practicing', 'practiced', 'practical', 'practicable']
use: ['uses', 'Use', 'use', 'used', 'Using', 'using', 'useful', 'usefully', 'usefulness']
made: ['made']
independ: ['independents', 'independent', 'independence', 'Independents', 'Independent', 'independently', 'Independence']
intern: ['Internationally', 'internally', 'International', 'Internal', 'international', 'internal', 'internationally', 'Internally', 'interne', 'internment']
train: ['trains', 'training', 'trained', 'train', 'trainings']
amend: ['amend', 'amended', 'Amendments', 'amendment', 'amendments', 'amends', 'Amendment', 'amending']
transpar: ['transparently', 'transparency', 'transparent', 'Transparent', 'Transparency']
take: ['takes', 'taking', 'take']
commiss: ['commission', 'Commission', 'commissioned', 'Commissioned', 'commissions']
follow: ['followers', 'Following', 'follow', 'following', 'follows', 'followed']
draft: ['Draft', 'drafted', 'draft', 'drafts', 'drafting']
onlin: ['online', 'Online']
committe: ['Committees', 'Committee', 'committee', 'committees']
disciplinari: ['disciplinary']
parliamentari: ['Parliamentary', 'parliamentary']
consid: ['considered', 'consider', 'considing', 'considers', 'considering']
investig: ['investigator', 'investigation', 'investigate', 'investigative', 'investigates', 'Investigation', 'investigated', 'investigations', 'Investigative', 'investigators', 'investigating']
one: ['ones', 'One', 'one']
accord: ['accord', 'accorded', 'accords', 'accordance', 'according', 'According', 'Accords']
function: ['functionally', 'functioning', 'functions', 'functional', 'function']
process: ['processed', 'processing', 'Processes', 'processes', 'process', 'Processing']
taken: ['taken']
internet: ['Internets', 'internet', 'Internetization', 'internetes', 'Internet']
conclud: ['conclude', 'concluding', 'concluded', 'concludes']
civil: ['Civil', 'civile', 'CIVIL', 'civility', 'civil']
regul: ['regulates', 'regulate', 'regulations', 'regulating', 'Regulation', 'Regulations', 'regulators', 'regulated', 'regulation', 'Regulating', 'regulator']
order: ['orders', 'Orders', 'Order', 'ordering', 'order', 'ordered']
posit: ['position', 'positions', 'Position', 'positives', 'positive', 'positively']
group: ['grouped', 'group', 'grouping', 'Groups', 'groups', 'groupings', 'Group']
ministri: ['Ministry', 'ministries', 'ministry']
respons: ['responses', 'responsibilities', 'responsive', 'response', 'responsibility', 'Response', 'responsible', 'responsibly', 'Responsibilities']
addit: ['Additional', 'additions', 'additionally', 'additional', 'addition', 'Additionally']
justic: ['justice', 'justices', 'Justice']
well: ['Welle', 'well', 'Well']
partli: ['partly']
websit: ['website', 'Website', 'Websites', 'websites', 'websit']
protect: ['protected', 'protect', 'Protections', 'Protect', 'protection', 'protections', 'Protection', 'protecting', 'protective', 'protects']
relat: ['Relations', 'relating', 'related', 'Related', 'relation', 'relate', 'relates', 'relations']
two: ['two', 'Two']
establish: ['Established', 'establishing', 'establishment', 'established', 'establishes', 'establishments', 'Establish', 'establish']
see: ['seeing', 'sees', 'See', 'see']
bodi: ['Body', 'body', 'bodies']
within: ['Within', 'within']
ensur: ['ensuring', 'ensures', 'ensured', 'ensure', 'Ensuring']
paragraph: ['paragraph', 'paragraphs']
privat: ['privatize', 'Private', 'Privatized', 'private', 'privatization', 'privately']
gift: ['gifts', 'gift']
secur: ['secured', 'securing', 'securities', 'Secure', 'secures', 'security', 'secure', 'Security']
receiv: ['receives', 'receive', 'received', 'receiver', 'receiving']
must: ['must']
provis: ['provision', 'provisions', 'Provisions', 'Provision']
specif: ['specificities', 'specification', 'specific', 'Specifically', 'specifics', 'specifications', 'specifically', 'specificity']
possibl: ['possible', 'possibility', 'possibly', 'possibilities']
number: ['numbers', 'Numbers', 'numbering', 'Number', 'number']
period: ['periodicals', 'periodic', 'Periodical', 'periodicity', 'periods', 'periodical', 'period', 'periodically']
data: ['data', 'Data']
power: ['Power', 'powers', 'Powers', 'power', 'Powerful', 'powerful']
time: ['timing', 'times', 'time', 'Time', 'Times', 'timely']
proceed: ['proceeding', 'proceedings', 'proceeded', 'proceed']
effect: ['effectively', 'effects', 'effected', 'effective', 'Effective', 'effectiveness', 'effect']
enforc: ['enforceability', 'enforces', 'enforced', 'enforceable', 'enforcement', 'enforcing', 'enforce', 'Enforcement', 'enforcements']
request: ['request', 'requesters', 'requests', 'Requests', 'requested', 'Request', 'requesting']
second: ['Second', 'secondment', 'seconded', 'second', 'secondments']
first: ['First', 'first']
oper: ['Operative', 'operators', 'operatives', 'operative', 'Operations', 'operability', 'Operation', 'Operator', 'operates', 'operate', 'operations', 'operator', 'operated', 'Operational', 'operating', 'operation', 'operational']
commun: ['communicated', 'Community', 'communicate', 'Communication', 'communism', 'communities', 'community', 'communications', 'communication', 'Communications', 'communicating']
mp: ['mp', 'MPs', 'mps', 'MP']
develop: ['Development', 'develop', 'developer', 'developers', 'developed', 'developing', 'develops', 'developments', 'development']
head: ['Heads', 'heads', 'headed', 'heading', 'head']
ii: ['II', 'ii']
candid: ['Candidates', 'candidates', 'candidate']
content: ['content', 'contents', 'contention', 'Content']
subject: ['subject', 'subjective', 'subjectivity', 'Subjected', 'subjects', 'subjected', 'Subject']
publish: ['published', 'Publishing', 'publishe', 'publish', 'publishing', 'publisher', 'publishes', 'publishers', 'Publishers']
countri: ['Countries', 'countries', 'Country', 'country']
prosecut: ['Prosecutions', 'prosecutions', 'prosecute', 'prosecutable', 'Prosecution', 'prosecuted', 'prosecution', 'prosecutes', 'prosecuting']
current: ['Currently', 'Current', 'currently', 'current']
matter: ['matter', 'matters', 'Matters']
asset: ['asset', 'assets']
make: ['Make', 'making', 'make', 'makes']
freedom: ['freedom', 'Freedom', 'Freedoms', 'freedoms']
assess: ['assess', 'assesses', 'assessment', 'assessing', 'assessments', 'assessed']
control: ['control', 'controls', 'controllers', 'controlling', 'controller', 'controlled', 'Control']
restrict: ['restricts', 'restricted', 'restrictions', 'restrict', 'restrictively', 'Restrictive', 'restrictive', 'restricting', 'Restrictions', 'restriction']
duti: ['duty', 'duties']
repres: ['representing', 'represents', 'representatives', 'Representatives', 'represent', 'Representative', 'represented', 'representative']
initi: ['initiative', 'initiating', 'Initiative', 'initiation', 'initial', 'initials', 'Initiatives', 'initiate', 'initiates', 'initiatives', 'initiated', 'initially']
place: ['Place', 'place', 'places', 'placed', 'placing']
percent: ['percent']
financi: ['Financial', 'Financially', 'financier', 'financial', 'financially']
institut: ['instituted', 'Institute', 'instituting', 'institutional', 'institutes', 'institute', 'institutions', 'institution', 'Institution']
sinc: ['Since', 'since']
director: ['Director', 'directorate', 'directors', 'directorates', 'director', 'Directorate', 'Directors']
level: ['levelled', 'Level', 'Levels', 'leveled', 'level', 'levels']
meet: ['meets', 'meet', 'meetings', 'meeting']
result: ['result', 'Results', 'resulting', 'results', 'resulted']
submit: ['submits', 'submit', 'submitting', 'submitted']
organis: ['organise', 'Organisation', 'organisational', 'organises', 'organisation', 'organising', 'organisations', 'organisers', 'organised', 'Organised']
account: ['account', 'Accounting', 'Account', 'accounting', 'accountants', 'accounts', 'Accountability', 'accountant', 'accountable', 'accountancy', 'Accounts', 'accountability', 'accounted']
need: ['needing', 'needed', 'needs', 'Needs', 'Need', 'need']
carri: ['carries', 'carrying', 'carried', 'carry']
appli: ['applied', 'applies', 'apply', 'applying']
staff: ['staff']
refer: ['refer', 'referred', 'referring', 'refers', 'reference', 'references']
particular: ['particularities', 'particular']
chang: ['Change', 'Changing', 'changing', 'Changes', 'change', 'changed', 'changes']
propos: ['propose', 'proposal', 'proposed', 'proposals', 'proposer', 'Proposal', 'Proposals', 'Proposed', 'proposing', 'proposes']
block: ['blockings', 'Block', 'Blocked', 'blocked', 'blocking', 'blocks', 'Blocking', 'Blocks', 'block']
limit: ['limit', 'limits', 'limitation', 'limited', 'limiting', 'Limited', 'Limitations', 'limitations', 'Limiting', 'Limits']
prime: ['Prime', 'prime']
individu: ['individual', 'individually', 'Individual', 'Individuals', 'individuals']
applic: ['applications', 'application', 'applicants', 'Application', 'applicability', 'Applications', 'applicable', 'applicant']
social: ['social', 'Social', 'Socialism', 'socially']
manag: ['manage', 'managing', 'managers', 'managed', 'management', 'manages', 'manager']
execut: ['executing', 'executed', 'executives', 'executive', 'Executive', 'Execution', 'execution', 'executions', 'execute']
monitor: ['monitored', 'Monitors', 'monitor', 'monitoring', 'monitors', 'Monitor', 'Monitoring']
oblig: ['obliging', 'oblige', 'obliged', 'obligated', 'obligate', 'obligation', 'obligates', 'obliges', 'obligations', 'Obligations']
certain: ['certain', 'Certain']
forc: ['forces', 'Force', 'Forced', 'forcing', 'Forces', 'force', 'forced']
appeal: ['Appeals', 'appealed', 'Appeal', 'appeal', 'appealing', 'appeals']
exampl: ['example', 'examples']
increas: ['increase', 'increased', 'increasing', 'increases']
organ: ['organs', 'organizes', 'organ', 'organizer', 'Organization', 'organizing', 'Organized', 'organizations', 'organization', 'organe', 'organized', 'organic', 'organizers', 'organize', 'Organizations']
recent: ['recently', 'Recent', 'Recently', 'recent']
action: ['action', 'Action', 'Actions', 'actions']
relev: ['relevance', 'relevant']
allow: ['allows', 'allowances', 'allow', 'allowing', 'allowed', 'allowance']
march: ['March', 'march', 'Marche', 'marches']
third: ['third', 'Third', 'thirds']
employ: ['Employment', 'employs', 'employer', 'employed', 'employment', 'employers', 'employing', 'employ', 'Employers']
view: ['viewed', 'viewing', 'view', 'views']
perform: ['Performance', 'perform', 'performance', 'performs', 'performing', 'performed', 'performances']
critic: ['critical', 'criticizes', 'critics', 'criticizing', 'criticize', 'criticism', 'Critical', 'Critics', 'criticisms', 'critically', 'critic', 'criticized']
anticorrupt: ['anticorruption', 'Anticorruption', 'AntiCorruption']
connect: ['Connections', 'connectivity', 'connections', 'Connectivity', 'connected', 'Connection', 'Connected', 'Connect', 'connecting', 'connection', 'connect']
without: ['without', 'Without']
sanction: ['sanction', 'sanctioning', 'sanctions', 'Sanctions', 'sanctioned']
polici: ['policy', 'policies', 'Policy']
address: ['addressed', 'addressing', 'addresses', 'address']
term: ['terms', 'termed', 'term']
set: ['set', 'settings', 'setting', 'sets']
round: ['rounds', 'rounded', 'round']
three: ['Three', 'three']
decemb: ['December', 'december']
influenc: ['influencers', 'Influence', 'influences', 'influencer', 'influencing', 'influenced', 'influence']
peopl: ['people', 'People', 'Peoples', 'peoples']
violat: ['violated', 'violating', 'Violations', 'violations', 'violators', 'violation', 'violate', 'violates']
select: ['Select', 'selection', 'selects', 'selective', 'selected', 'selecting', 'select', 'Selected', 'selectively', 'Selective']
confidenti: ['confidentially', 'Confidentiality', 'confidentiality', 'confidential']
compani: ['companies', 'Companies', 'companys', 'Company', 'company']
basi: ['basis']
contain: ['contains', 'contain', 'containing', 'contained']
russian: ['Russians', 'Russian', 'russian']
form: ['forming', 'formed', 'Forms', 'forms', 'form']
june: ['June', 'june']
major: ['majoring', 'major', 'majorities', 'Major', 'majority']
deputi: ['deputies', 'deputy', 'Deputies']
avail: ['available', 'availability', 'Available']
agenc: ['agencies', 'agency', 'Agency']
situat: ['Situation', 'situations', 'situated', 'situation', 'Situations']
complaint: ['Complaints', 'complaint', 'complaints']
octob: ['october', 'October']
principl: ['principles', 'Principles', 'principle']
support: ['supports', 'supporter', 'supportive', 'supporters', 'support', 'Support', 'supporting', 'Supporters', 'Supports', 'supported']
discuss: ['Discussion', 'discussed', 'discussion', 'discusses', 'discussions', 'discussing', 'discuss']
post: ['Posts', 'Postes', 'posts', 'postings', 'post', 'posting', 'posted', 'Post']
consult: ['consulting', 'consultancies', 'consult', 'Consultation', 'Consultant', 'consultation', 'consultancy', 'consultants', 'consulted', 'consultations', 'Consult', 'consultative']
could: ['could']
indic: ['indications', 'indicative', 'indicating', 'indicators', 'indication', 'indicate', 'Indicators', 'indicates', 'indicated']
welcom: ['welcomed', 'welcoming', 'welcome', 'welcomes']
sever: ['severity', 'Severe', 'severe', 'severely', 'several', 'Several', 'severance']
continu: ['continuous', 'continue', 'continuously', 'continued', 'Continue', 'continuity', 'continuation', 'continues', 'continuing']
cover: ['covered', 'covers', 'coverings', 'covering', 'cover']
risk: ['risk', 'risked', 'risks']
high: ['high', 'High']
improv: ['improved', 'improve', 'Improvements', 'improvement', 'improving', 'improvements', 'improves']
recal: ['recalled', 'recalls', 'recall']
regist: ['registering', 'register', 'registers', 'registered', 'Registered']
therefor: ['therefore', 'Therefore']
introduc: ['introduces', 'introducing', 'Introduces', 'introduce', 'Introduce', 'introduced', 'Introducing']
plan: ['planning', 'plans', 'Planning', 'planned', 'Plan', 'plan', 'Plans']
given: ['given', 'Given']
ptef: ['ptef', 'ptefs']
profession: ['professional', 'professionally', 'professionalism', 'Professional', 'professionals']
promot: ['promoted', 'promotional', 'promotes', 'promote', 'promotion', 'promotions', 'promoting']
involv: ['involve', 'involved', 'involves', 'involvement', 'involving', 'Involvement']
document: ['documented', 'documenting', 'documentation', 'Documents', 'document', 'documents']
suprem: ['supreme', 'Supreme', 'suprem']
union: ['union', 'unionized', 'Union', 'unione', 'Unions', 'unions', 'unionize']
seat: ['seat', 'seats', 'seated']
call: ['calling', 'called', 'Calling', 'Calls', 'call', 'Call', 'calls']
human: ['Human', 'human', 'humanities', 'humanity']
secretari: ['secretary', 'Secretary', 'secretarial', 'secretaries']
user: ['users', 'user', 'User', 'Users']
standard: ['standards', 'standard', 'Standards']
contact: ['contacts', 'contact', 'contacted', 'contacting']
campaign: ['campaign', 'campaigns', 'Campaign', 'campaigner', 'campaigners', 'Campaigns', 'campaigned', 'campaigning']
european: ['european', 'European', 'Europeans']
express: ['Expression', 'expresses', 'expressed', 'express', 'expressions', 'expression', 'expressing']
exercis: ['Exercise', 'exercising', 'exercised', 'exercises', 'exercise']
area: ['Area', 'Areas', 'areas', 'area']
mobil: ['mobilization', 'Mobile', 'mobilizing', 'mobilized', 'mobilize', 'mobile', 'Mobil', 'mobility', 'mobiles']
approv: ['approves', 'approve', 'Approval', 'approving', 'approved', 'approval']
depart: ['departments', 'department', 'Department', 'departing', 'depart']
direct: ['direct', 'direction', 'Directive', 'directives', 'directed', 'directs', 'Direct', 'directions', 'directive', 'directing']
among: ['Among', 'among']
free: ['free', 'Free']
offenc: ['offences', 'Offences', 'offence']
assembl: ['assembly', 'Assemblies', 'Assembly', 'assemble', 'assembled', 'assemblies']
local: ['localization', 'local', 'localized', 'Local', 'locally']
outlet: ['Outlets', 'outlets', 'outlet']
base: ['base', 'basing', 'bases', 'Based', 'based']
citizen: ['citizens', 'Citizens', 'citizen', 'Citizen']
role: ['role', 'roles']
prohibit: ['prohibitive', 'prohibits', 'prohibitively', 'prohibited', 'prohibiting', 'prohibitions', 'prohibit', 'prohibition']
variou: ['Various', 'various']
framework: ['frameworks', 'framework']
final: ['final', 'Final', 'finalized', 'finally', 'Finally']
unit: ['unite', 'Unit', 'United', 'unit', 'united', 'units']
month: ['Month', 'months', 'month']
end: ['end', 'Ends', 'End', 'ends', 'ending', 'ended']
question: ['question', 'questioning', 'questions', 'questioned', 'questionable']
remov: ['removed', 'remove', 'removals', 'Removal', 'Remove', 'removing', 'Removing', 'removal', 'removes']
januari: ['January', 'january']
april: ['April', 'april']
employe: ['employee', 'employees']
servant: ['servants', 'servant']
fund: ['funds', 'fund', 'funding', 'Fund', 'funded', 'Funding']
though: ['though', 'Though']
section: ['Sections', 'Section', 'sections', 'section']
